


NO ./textures/kandinsky-circles.xpm

     SO    ./textures/pavlin.xpm
C 170,188,251

EA        ./textures/space.xpm
WE ./textures/kandinsky-snow.xpm

F         109,151,121

111111111111111111111111111111
1111111111110000000001111000011
1111111111D1111111100010000001
111111000000000000000000011111
1111000000N0111111100001111111
111D000000000000D100000000D111
111100000000111111110000001111
100000000000000000000000000011
1001D1000111110000001110001111
100111001111111D10000000001111
111111111111111111111111111111



